#...##S#
#.#.##.#
#.#.#..#
#.*@*.#^
#.#*#.#^
#.....#^
#######^
^^^^^^^^