#......#
#.######
#...#.@#
#.#.#.##
#.#...##
#.####.#
#...S..#
########