S...#R.#
.##.##w#
.#W....#
.#######
....r..#
######.#
@......#
########