.###.#.#
##.b.###
..G#.r.#
.#w#.###
.gB#.r.#
.#*#.###
..S#.b@#
########