###...
##..#.#....
.##*.###.*#
##...*....#
#......#..#
###..###..#
..#.*#....#
.##.##.#.##
.#.....*##
.#..*..##
#.......