...###
..##.#.####
.##*.###.*#
##...*....#
#...@..#..#
###..###..#
..#.*#....#
.##.##.#.##
.#.....*##
.#..*..##
.#######